10 10
2 5 3 0 3 4 4 0 1 0  
1 1 0 2 5 1 3 3 1 4  
2 2 1 4 3 0 5 5 1 2  
1 0 3 2 3 2 1 2 4 1  
5 3 2 0 0 3 4 2 5 1  
3 2 0 4 5 5 1 0 0 3  
4 1 3 1 5 2 4 3 1 0  
1 3 0 2 1 3 3 4 0 2  
5 5 4 3 4 1 2 3 5 2  
0 0 1 2 0 5 3 2 1 4  