15 15
3 1 5 0 2 4 5 5 1 0 3 2 4 4 1
0 0 2 5 5 1 1 4 2 5 0 4 3 4 2
4 2 2 5 0 4 2 1 4 5 5 1 3 3 4
1 1 4 2 1 0 0 2 4 5 1 3 3 0 5
2 0 1 4 0 3 3 0 5 1 4 0 3 2 1
5 4 0 1 2 3 4 5 2 0 1 2 4 3 2
0 2 5 0 4 1 0 2 5 2 4 1 0 2 5
3 1 0 5 2 4 4 1 0 5 2 4 4 1 0
1 0 1 2 5 4 1 0 4 2 5 4 1 0 3
4 4 2 0 1 2 4 0 2 0 1 1 4 0 2
2 4 3 1 0 5 5 4 3 1 0 5 5 4 3
5 3 3 3 2 0 5 3 3 4 2 5 5 3 1
3 3 3 3 3 2 0 1 4 0 1 2 0 1 4
3 3 3 3 3 3 3 2 5 5 4 3 1 2 5
3 3 3 3 3 3 3 0 2 5 1 4 3 0 2
