5 5
0 2 1 5 4  
3 1 3 0 0  
2 5 1 4 1  
4 0 3 2 2  
5 5 0 4 3  